NO ./textures/wolfenstein/blue_stone.xpm
SO ./textures/wolfenstein/wood.xpm
WE ./textures/wolfenstein/mossy.xpm
EA ./textures/wolfenstein/eagle.xpm

F 255,255,255
C 225,55,10

        1111111111111111111111111
        1000000000110000000000001
        1011000001110000000000001
        1001000000000000000000001
111111111011000001110000000000001
100000000011000001110111111111111
11110111111111011100000010N01
11110111111111011101010010001
11000000110101011100000010001
10000000010000001100000010001
10000000000000001101010010001
1100000111010101111101100000111
11110111 1110101 101111010001
11111111 1111111 111111111111
