NO ./assets/textures/1.xpm
SO ./assets/textures/2.xpm
WE ./assets/textures/3.xpm
EA ./assets/textures/4.xpm

F 255,255,0
C 225,30,0

11111111111
10000000001
1E000000001
11111111111
