NO ./textures/wolfenstein/blue_stone.xpm
SO ./textures/wolfenstein/wood.xpm
WE ./textures/wolfenstein/mossy.xpm
EA ./textures/wolfenstein/eagle.xpm

F 0,255,255
C 225,255,255

11111111111
10000000001
1100E001001
10000000001
11111111111
