NO textures/test/north.xpm
SO textures/test/south.xpm
WE textures/test/west.xpm
EA textures/test/east.xpm

C 225,255,255
F 0,255,255

11111111111
10011100001
110N0010011
10011100001
11111111111
