111111111111
100000000001
100000000001
100010000001
100000000001
100000000001
100000000001
100000000001
100000001001
100000000001
111111111111