NO textures/test/north.xpm
SO textures/test/south.xpm
WE textures/test/west.xpm
EA textures/test/east.xpm

F 0,255,255
C 225,255,255

11111111111
10011100001
110E0010011
10011100001
11111111111
